111111111111111111111111111111111111111111111111
1000C0000000000000H00000000000000000000000000001
10000000000000000000000000H0000H00000C0000H00001
1000001110000011111HHH0HH11111000000111111100001
100000101000H00000010000000000100000000000100001
10000000100000000001HHH0HH0000100000000001000001
100000001000C000111000E00001110000C00000100H0001
100H0H0010000000111HHHHHHHH111000000000100C00001
1000000010000000000100000H000010000000100H000001
100000001000000000C1000H00000C1000000100000H0001
1000001111100011111000000111110000001H0000000001
1000000000000000P00000H0000000000H0000000H000001
111111111111111111111111111111111111111111111111