1111111111111111111111111111111111
1000000000000000000000000000000001
10000000E0000000000000000000000001
1000000000000000000000000000000001
1000000000000000000000000000000001
1000000000000000000000000000000001
1000000000000000000000000000000001
1000000G000000000000000000G0000001
1000000000000000000000000000000001
1000000000000000000000000000000001
1000000000000000000000000000000001
100000000000000P000000000000000001
1000000000000000000000000000000001
1000000000000000000000000000000001
1000000000000000010G10000000000001
1000000000000000000000000000000001
1000000000000000000000000000000001
1000000000000000000000000000000001
1000000000000000000000000000000001
1000000000000000000000000000000001
1000000000000000000000000000000001
1000000000000000000000000000000001
1000000000000000000000000000000001
1000000000000000000000000000C00001
1000000000000000000000000000000001
1111111111111111111111111111111111