11111111111111111111111111111111111111111
1P0000E0000000000000000000000000000000001
10000000000000000C000000000000000C0000001
10000000000000000000000000000000000000001
10101010101010101010101010000C00001111111
10000000000000000000001011111111011111111
100000000000C0000000001011111111011111111
100000100000C0000000001011111111011111111
100000000000C0000000001011111111H11111111
100000000000C0000000001011111110011111111
100000000000C00000000010000000H0C11111111
100000000000C0000000001011110111011111111
10000000000000000000001E11110000011111111
11111111111111111111111111111111111111111