1111111111111111111111111111111
1011000011101111111011111E10111
1001111100110000001001001011101
11010G0000010101001001011010101
1101110110110101101011010010111
1100010100100100101110011010001
1011110111110100100011101011101
10100C000000001011100G001000111
1110011111111010001111101010011
100111000000C01111000010G011011
11010001011111000101111010C1011
1101011101010000110001001101011
1101000011010111100011001001111
1001001110011100001110111000101
110101000G000000111000001011101
1101010111111101101101111010011
1111010001000100000100010010011
1010011100010111110101110110011
10110001100100G0011100100100111
1110000011011011000011110111101
100010C001001110010010000C00111
1010011101110001011110111100011
1010010100010101100001100101011
10101101110101001101110001010C1
10111011000101000111C1101101011
1000C0001111010000G000101001111
1010111000100111101110101100011
11101011000000G0011011000111011
11C0100001011111000001110101011
111011C111010000010100010001011
101001110111011111P111111111011
1111111111111111111111111111111