1111111111111111111111111111111111
1E0000000000000C00000C000000000001
101001010010000010100100000H010101
10100100101010100010010000H00101H1
1P0000000C00C00000000000H0000000C1
1111111111111111111111111111111111