1111111111111111111111111111111111
100001010001010C01010C00G100100001
100100100100100100100110001100E001
1P1010C01010C01010C0100100C0000001
1111111111111111111111111111111111